10111111
1      1
1  1   1
1      1
11 2   1
11111111
